Cannington=CAN
Joondalup=JNP
Kelmscott=KELM
Rockingham=ROCK
SUCCESS=SUC
Mirrabooka=MBK
Midland=MID
West Perth=CTYW
Mandurah=MDH
Albany=ALB
Augusta=AUGO
Australind=AUSO
Beverley=BEVO
Boddington=BODO
Boyup brook=BOYO
Bridgetown=BRIO
Brookton Bendigo Bank=BBKO
Broome=BRM
Bruce Rock=BRUO
Bunbury=BNY
Busselton DOT=BSNDT
Carnamah=CMHO
Carnarvon=CAR
Collie Post Shop=CLLE
Coorow=CRWO
Corrigin=CORO
Cranbrook=CBKO
Cunderdin Crc=CCRO
Dallwallinu=DALO
Denham=SBYO
Denmark=DENO
Derby=DERO
Dongara Crc=DCRO
Donnybrook=DOWO
Esperence=ESPDP
Exmouth=EXM
Fitzroy=FIZO
Geraldton=GTN
Gingin=GGNO
Gnowanger=GNWO
Goomalling=GOOO
Halls Creek=HALO
Harvey=HARO
Hopetoun Shire=HOPO
Jerramungup=JERO
Jurien Bay Bendigo Bank=DCBO
Kalgoorlie=BLD
Kambalda PO=KMBO
Kamblada West=KAMO
Karratha=KAR
Katanning=KATO
Kellerberrin=KELO 
Kojonup=KOJO
Kondinin=KONO
Koorda=KORO
Kulin=KBBO
Kununurra=KUN
Lake Grace=LGCO
Laverton=LAVO
Leeman=LEEO
Leinster=LEIP
Manjimup=MJCO
Margaret River=MGTO
Meedac Kalbarri=KALO
Meekatharra=MCRO
Merredin=MERO
Mingenew=MIGO
Moora=MOOE
Morawa=MOWO
Mount Baker=PLAO
Mount Magnet Shire=MMAO
Mukinbudin=MUKO
Mullewa=MULO
Nannup=NANO
Narembeen=NMBO
Narrogin=NGNO
Newman=NEW
Norseman=DNDO
Northam=NORO
Northampton=NTHO
Onslow=ONS
Pannawonica=PANP
Paraburdoo=PAR
Pingelly=PGYO
Quairading=QDGO
Ravensthorpe=RAVO
Roebourne=ROEE
South Headland=SHDD
Southern Cross=YILO
Tambellup=TAMO
Three Springs=TSPO
Tom Price=TOM 
Toodyay=TBBO
Trayning=TRYO
Wagin=WAGO
Waroona=WARO
Williams=WLMO
Wongan Hills=WONO
Wyalkatchem=WYCO
Wyndam=WYNO
Yalgoo=YLGO
York=YORO


